# #####################################################
# 
# first 3 numbers on first line are x y z size 
#
# level data max length 1000 (10x10x10)
# air = 0
# block = 1
# brick = 2
# door = 3
# barrel = 4
# man = 5
#
# levels are ended by =
# the last = is necessary because im a bad programmer
# 
# #####################################################

6 3 5 

0 0 0    1 0 0    1 0 0    1 0 0    1 0 0    1 0 0  
3 0 4    1 5 0    1 0 0    1 0 0    1 0 0    1 0 0  
0 0 0    1 0 0    1 0 0    1 0 0    1 0 0    1 0 0  
0 0 0    1 0 0    1 0 0    1 0 0    1 0 0    1 2 2  
0 0 0    1 0 0    1 0 0    1 0 0    1 0 0    1 0 0  

=

6 3 5

0 0 0    0 0 0    1 0 0    1 0 0    1 0 0    1 0 0 
3 0 0    2 0 0    1 5 0    1 0 0    1 0 0    1 0 0 
0 0 0    0 0 0    1 0 0    1 0 0    1 0 0    1 0 0 
0 0 0    0 0 0    1 0 0    1 0 0    1 0 0    1 2 4 
0 0 0    0 0 0    1 0 0    1 0 0    1 0 0    1 0 0 

=

11 7 5

0 0 0 0 0 0 0    0 0 0 0 0 0 0     0 1 1 1 0 0 0    0 2 2 2 2 2 0    0 1 1 1 0 0 0    2 2 2 2 0 0 0    1 1 1 1 0 0 0    0 0 0 0 0 0 0    0 0 0 0 0 0 0   0 0 0 0 0 0 0   0 0 0 0 0 0 0 
0 0 0 0 0 0 0    0 0 0 0 0 0 0     0 2 2 2 0 0 0    0 2 2 2 0 0 0    0 2 2 2 0 0 0    2 2 2 2 2 2 0    2 2 2 2 0 0 0    2 0 0 0 0 0 0    1 0 0 0 0 0 0   0 0 0 0 0 0 0   3 0 0 0 0 0 0 
0 0 0 0 0 0 0    0 0 0 0 0 0 0     0 1 1 1 0 0 0    0 2 2 2 5 0 0    0 1 1 1 0 0 0    2 2 2 2 0 0 0    1 1 1 1 0 0 0    0 0 0 0 0 0 0    0 0 0 0 0 0 0   0 0 0 0 0 0 0   0 0 0 0 0 0 0 
0 0 0 0 0 0 0    0 0 0 0 0 0 0     0 2 2 0 0 0 0    0 2 2 2 0 0 0    0 2 2 2 0 0 0    0 2 2 2 0 0 0    0 2 2 2 0 0 0    0 0 0 0 0 0 0    0 0 0 0 0 0 0   0 0 0 0 0 0 0   0 0 0 0 0 0 0 
0 0 0 0 0 0 0    0 0 0 0 0 0 0     0 1 1 0 0 0 0    0 2 2 0 0 0 0    0 1 1 1 0 0 0    0 2 2 2 0 0 0    0 1 1 1 0 0 0    0 0 0 0 0 0 0    0 0 0 0 0 0 0   0 0 0 0 0 0 0   0 0 0 0 0 0 0 

=

9 6 1

1 2 2 2 2 2    1 2 2 2 2 2    1 2 0 0 0 0   1 2 5 3 0 0    1 2 0 0 0 0    1 2 2 0 0 0    1 2 0 0 0 0    1 2 0 0 0 0    1 2 2 2 2 0 

= 


9 3 7

0 0 0   0 0 0   0 0 0    2 0 0    0 0 0    3 0 0    0 0 0   0 0 0   0 0 0 
0 0 0   0 0 0   0 0 0    1 5 0    0 0 0    1 0 0    0 0 0   0 0 0   0 0 0 
2 0 0   1 0 0   2 0 0    2 0 0    2 0 0    2 0 0    0 0 0   0 0 0   0 0 0 
2 0 0   1 0 0   2 0 0    1 0 0    2 0 0    1 0 0    2 2 2   1 0 0   0 0 0 
2 2 2   2 0 0   2 0 0    2 0 0    2 0 0    2 0 0    2 0 0   2 2 0   2 0 0 
2 0 0   1 0 0   2 0 0    1 0 0    2 0 0    1 0 0    2 0 0   1 1 1   0 0 0 
2 0 0   2 0 0   2 0 0    2 0 0    2 0 0    2 0 0    2 0 0   2 0 0   0 0 0 

=

9 3 7

0 0 0   0 0 0   0 0 0    2 0 0    0 0 0    3 0 0    0 0 0   0 0 0   0 0 0 
0 0 0   0 0 0   0 0 0    1 5 0    0 0 0    1 0 0    0 0 0   0 0 0   0 0 0 
2 0 0   2 0 0   2 0 0    2 0 0    2 0 0    2 0 0    0 0 0   2 0 0   0 0 0 
2 0 0   1 0 0   2 0 0    1 0 0    2 0 0    1 0 0    2 2 2   1 0 0   0 0 0 
2 2 4   2 0 0   2 0 0    2 0 0    2 0 0    2 0 0    2 0 0   2 2 0   2 0 0 
2 0 0   1 0 0   2 0 0    1 0 0    2 0 0    1 0 0    2 0 0   1 1 1   0 0 0 
2 0 0   2 0 0   2 0 0    2 0 0    2 0 0    2 0 0    2 0 0   2 0 0   0 0 0 

=